...1,Gene Name,Product Name,Left-End-Position,Right-End-Position,length,Direction,left_oligo_pos,right_oligo_pos,oligo
0,3'ETS-<i>leuZ</i>,small regulatory RNA 3'ETS<sup><i>leuZ</i></sup>,1991748,1991814,66,+,1991747,1991815,TGGTGATTAAAAATTAAGGAGGGTGTAACGACAAGTTGCAGGCACggcttgtcgacgacggcggtctccgtcgtcaggatcatTGGTACCCGGAGCGGGACTTGAACCCGCACAGCGCGAACGCCGAG
1,agrA,small RNA AgrA,3648063,3648144,81,+,3648062,3648145,AGCACGTCCTTGCAATAGTTTCAGTATGGTATTAGCATTGATGCGggcttgtcgacgacggcggtctccgtcgtcaggatcatACATCCGGATTCGGACAAGGCTTAATATGACGATGACCCAGTGAA
2,agrB,small regulatory RNA AgrB,3648294,3648375,81,+,3648293,3648376,CGCTAATTCTTGCAATGTTAGCCACTGGCTAATAGTATTGAGCTGggcttgtcgacgacggcggtctccgtcgtcaggatcatACGTCCTGATTCAGACCTCCTTTCAAATGAATAGCCAACTCAAAA
3,arcZ,small regulatory RNA ArcZ,3350577,3350697,120,+,3350576,3350698,ACTGATTCATGTAACAAATCATTTAAGTTTTGCTATCTTAACTGCggcttgtcgacgacggcggtctccgtcgtcaggatcatAGTGGCTTTTGCCACCCACGCTTTCAGCACTTCTACGTCGTGACG
4,arrS,small regulatory RNA ArrS,3657985,3658054,69,+,3657984,3658055,CTGAAGACATGAATGCGTTATTTACTCAGGTAATTTCAATGCGTTggcttgtcgacgacggcggtctccgtcgtcaggatcatATTTTAACTTTAGTAATATTCTTCAGAGATCACAAACTGGTTATT
5,C0293,small regulatory RNA C0293,1196711,1196782,71,+,1196710,1196783,AAGATGTATGTGAAGGGGCCGCGCTCGCGGCCTTTTTTACATTCCggcttgtcgacgacggcggtctccgtcgtcaggatcatGTTGATACAAAACCGGCAATTTAACAATATTTGAGCGGGTGTAAG
6,chiX,small regulatory RNA ChiX,507204,507287,83,+,507203,507288,CACTACACCTGTATGGAGAAGGGAATTTGCCGCAAATGTTGCGCTggcttgtcgacgacggcggtctccgtcgtcaggatcatAACTCGATTGTCGCTCAATCTCACCATCCTGCCAATACTCTTAGG
7,cpxQ,small regulatory RNA CpxQ,4106330,4106387,57,+,4106329,4106388,AAGCAAATCATCTGCAATGCATTAAGCAGCAGGCAAATTGAGGATggcttgtcgacgacggcggtctccgtcgtcaggatcatCAGGGTTTACTACTGGGAACGTGAGTTGCTACTACTCAATAGCTT
8,csrB,small regulatory RNA CsrB,2924156,2924524,368,+,2924155,2924525,CATAAAGCAACCTCAATAAGAAAAACTGCCGCGAAGGATAGCAGGggcttgtcgacgacggcggtctccgtcgtcaggatcatGAAGATAGAATCGTCTTTTTCGCGAAGTCTTACAAGGCGCTTACA
9,csrC,small regulatory RNA CsrC,4051036,4051281,245,+,4051035,4051282,TTTTATTCAGTATAGATTTGCGGCGGAATCTAACAGAAAGCAAGCggcttgtcgacgacggcggtctccgtcgtcaggatcatGGGTGCTACTTTACGCCTTTGCTTTAAACAAACAATCAACCGCCA
10,cyaR,small regulatory RNA CyaR,2167114,2167200,86,+,2167113,2167201,AACCGATCACATACAGCTGCATTTATTAAGGTTATCATCCGTTTCggcttgtcgacgacggcggtctccgtcgtcaggatcatACGCGTAATACAATGAAATAAAAGGATTTATTTCTGGTCACGTCC
11,dicF,Qin prophage; small regulatory RNA DicF,1649382,1649434,52,+,1649381,1649435,ATACGCTTAAGTGACAACCCCGCTGCAACGCCCTCTGTTATCAATggcttgtcgacgacggcggtctccgtcgtcaggatcatTTTTTAAAGTGAATTTTGTGATGTGGTGAATGCGGCTGAGCGCAC
12,dsrA,small regulatory RNA DsrA,2025223,2025313,90,+,2025222,2025314,ATTCATGACTTCAGCGTCTCTGAAGTGAATCGTTGAATGCACAATggcttgtcgacgacggcggtctccgtcgtcaggatcatCATCACCTTATCCGCAATTTTTTTCGCTGACAAGAAAATATTCGC
13,esrE,small RNA EsrE,4019978,4020229,251,+,4019977,4020230,AAAAAGTGCGAATGATGAAATATAGGCGCCGTACTTCACCTGGCGggcttgtcgacgacggcggtctccgtcgtcaggatcatGTCGAACTCTGCCAGATCTGCCAGCGCAACGAAGTTTTGCACCAC
14,eyeA,CP4-6 prophage; small RNA EyeA,272580,272654,74,+,272579,272655,CGTCGCTGACCTTCCCCGGTTTACCTGCCTGGACTCAGGCATACTggcttgtcgacgacggcggtctccgtcgtcaggatcatCGCTGCTGCCCCGGTGTTTCGCATACATGTCAAAACACCTTCGAC
15,ffs,signal recognition particle 4.5S RNA,476448,476561,113,+,476447,476562,TTAGCCATGTTGGGATTTTTTGACGAAACGGTGGGAGGCAGAAATggcttgtcgacgacggcggtctccgtcgtcaggatcatATTGAGAGCGTTGAGAACCAACGCGCAGGCGCATTATCACTGCTG
16,fnrS,small regulatory RNA FnrS,1409129,1409250,121,+,1409128,1409251,TCATTGGGTGGACTCTTAAAGGGTAGACGCTGATAAATAACAGGCggcttgtcgacgacggcggtctccgtcgtcaggatcatAAGAGAGATATTGCCCTGAATGGGTAGAGAGTTTATTGACTTCGC
17,G0-10706,small RNA,4441225,4441330,105,+,4441224,4441331,CTGTCTGAATTTTAACCCTCTGGCGGCTTTACAGTACCTTACGCTggcttgtcgacgacggcggtctccgtcgtcaggatcatGGATAAGATATGTTAAACAGTATTTTAGTCATACTCTGCTTGATC
18,gadF,small regulatory RNA GadF,3658992,3659082,90,+,3658991,3659083,TGATTTCATTACCCCCGGTGATTACTAAAGGAGAGGCTAAAACGAggcttgtcgacgacggcggtctccgtcgtcaggatcatGTCGTTGACCTCACCATGTCGATCACTGTGCCTGTATCCCACCTT
19,gadY,small regulatory RNA GadY,3664864,3664969,105,+,3664863,3664970,AAAAAAATGGCTGATCTTATTTCCAGTAAAAGTTATATTTAACTTggcttgtcgacgacggcggtctccgtcgtcaggatcatATGTCTGAGTAAAACTCTATAATCTTATTCCTTCCGCAGAACGGT
20,gcvB,small regulatory RNA GcvB,2942696,2942901,205,+,2942695,2942902,AAATTGTCCGTTGAGCTTCTACCAGCAAATACCTATAGTGGCGGCggcttgtcgacgacggcggtctccgtcgtcaggatcatACCTTGCGATCGCGAATTACTGATCCAGTTCGACCATCTCTTTCA
21,glmY,small regulatory RNA GlmY,2691157,2691340,183,+,2691156,2691341,TCAGACGCGAATAGCCTGATGCTAACCGAGGGGAAGTTCAGATACggcttgtcgacgacggcggtctccgtcgtcaggatcatGGTTACTATTATGCAGTAACTGTGCCAATAAAGAAAATAGTTTGG
22,glmZ,small regulatory RNA GlmZ,3986432,3986603,171,+,3986431,3986604,CCTGATACATAAAAAAACGCCTGCTCTTATTACGGAGCAGGCGTTggcttgtcgacgacggcggtctccgtcgtcaggatcatTCGTTTATTATGCCACAGAGAATCGGGAAATAACATCCCTTAACA
23,ipeX,small RNA IpeX,574367,574515,148,+,574366,574516,TCGTTGCTGTAGGTCTGGTTTACCAGTTCTAATCTGATTACGAAAggcttgtcgacgacggcggtctccgtcgtcaggatcatAATAATTTTTAGTAAACAATTGGCATATTAATTAGAGTTATTAAC
24,isrC,CP4-44 prophage; small RNA IsrC,2071317,2071511,194,+,2071316,2071512,TACTGTCTCTCTTGTCCGTGCAATAGCTCAATAATAGAATAAAACggcttgtcgacgacggcggtctccgtcgtcaggatcatATTCACCCTCAATCTAAGGAAAAGCTGATGAAACGACATCTGAAT
25,istR,small regulatory RNA IstR-1,3853118,3853257,139,+,3853117,3853258,GAAAATTGAGGGGTTGATCACGTTTTGTACTGAATTGCAGATAACggcttgtcgacgacggcggtctccgtcgtcaggatcatATAGTTGAGTATCGATCACAGTTTGCGTTTTGTCCAAATATTACT
26,mcaS,small regulatory RNA McaS,1405658,1405751,93,+,1405657,1405752,TGAAGAAAATTGGCAACTAAAGGTTAAAACCGTTATAACACAGTCggcttgtcgacgacggcggtctccgtcgtcaggatcatATGCAGTTTTAACTTTGCAGATAGCCGCATTCTCGCCGGAATTGC
27,mgrR,small regulatory RNA MgrR,1622817,1622914,97,+,1622816,1622915,CCCTTGTTACAGTTGTGTACAAGGGGCCTGATTTTTATGACGGCGggcttgtcgacgacggcggtctccgtcgtcaggatcatGTTGACACAGTAGCATCAGTTTTCTCAATGAATGTTAAACGGAGC
28,micA,small regulatory RNA MicA,2814802,2814874,72,+,2814801,2814875,TAAAAATTTTCTGAACTCTTTCTTCCCAGGCGAGTCTGAGTATATggcttgtcgacgacggcggtctccgtcgtcaggatcatCTTTTCTGTCAGGCGTGTTTTTCCAGCCACACCGCAAACGGTTCG
29,micC,small regulatory RNA MicC,1437121,1437231,110,+,1437120,1437232,AAAGCAACACCGATTAAATGCTCTGGATAAGGATTATCCAATTCTggcttgtcgacgacggcggtctccgtcgtcaggatcatCCGCGCAGAATAACGTATAGCAAATTAAAAGTATAATTTTTATTT
30,micF,small regulatory RNA MicF,2313084,2313176,92,+,2313083,2313177,CTGAATGTCAAAACAAAACCTTCACTCGCAACTAGAATAACTCCCggcttgtcgacgacggcggtctccgtcgtcaggatcatACCCTTCTTTACACACTTTTCATTATTCTGTGCTACCACAGAAAA
31,micL,small regulatory RNA MicL-S,1958441,1958520,79,+,1958440,1958521,TCAACAGATCACGGTTATCGTTCGTTTTTTATACTGTTCAGGGATggcttgtcgacgacggcggtctccgtcgtcaggatcatCATTTGGCCTGATGGCGTTCAATGATTCCTTTCATTTCAGCAACC
32,naRNA1,naRNA1,4326305,4326381,76,+,4326304,4326382,GAAATCTGAGTTTGTGAAAAAGAACTGATTGTATTGTGATCGGTAggcttgtcgacgacggcggtctccgtcgtcaggatcatTACAAATTCCCGCACCCTCCGTAGGCCGGATAAGGCGTTTACGCC
33,naRNA2,naRNA2,4326205,4326281,76,+,4326204,4326282,CGCTTGCGCGTCTTATCAGGCCTACAAATTCCCGCACCCTCCGTAggcttgtcgacgacggcggtctccgtcgtcaggatcatTACAAATTCCCGCACCCTCCGTAGGCCGGATAAGGCGTTTACGCC
34,naRNA3,naRNA3,4326105,4326181,76,+,4326104,4326182,CGCTTGCGCGTCTTATCAGGCCTACAAATTCCCGCACCCTCCGTAggcttgtcgacgacggcggtctccgtcgtcaggatcatTACAAATTCCCGCACCATCCGTAGGCCGGATAAGGCGTTTACGCC
35,naRNA4,naRNA4,4326005,4326081,76,+,4326004,4326082,CGCTTGCGCGTCTTATCAGGCCTACAAATTCCCGCACCATCCGTAggcttgtcgacgacggcggtctccgtcgtcaggatcatTACAAATTCCCGCACCCTCCGTAGGCCGGATAAGGCGTTTACGCC
36,naRNA5,naRNA5,4325905,4325981,76,+,4325904,4325982,CGCTTGCGCGTCTTATCAGGCCTACAAATTCCCGCACCCTCCGTAggcttgtcgacgacggcggtctccgtcgtcaggatcatTACAAATTCCCGCACCCTCCGTAGGCCGGATAAGGCGTTTACGCC
37,naRNA6,naRNA6,4325805,4325881,76,+,4325804,4325882,CGCTTGCGCGTCTTATCAGGCCTACAAATTCCCGCACCCTCCGTAggcttgtcgacgacggcggtctccgtcgtcaggatcatGCCTCTCATCTGTATAAATTTCGAACTACACTTAACTGGCTTCTC
38,nc1,small noncoding RNA involved in nucleoid organization,297137,297304,167,+,297136,297305,CAGTATTTTGATGAATTGCCAAGGTTACAATGGCACAAATACGGCggcttgtcgacgacggcggtctccgtcgtcaggatcatTTATAGCAATAAACCCGTTGATTGAAATTAACAAAAGTTGATGTT
39,och5,small regulatory RNA Och5,3067187,3067344,157,+,3067186,3067345,TTGCGCATCTTTTTCGAAATAAAAATGTCCATCCCCCTCCCCCGCggcttgtcgacgacggcggtctccgtcgtcaggatcatGTGCTGCAGGTGTTTTAGCGGGTTGTTGATCCACAGGTTCTAACT
40,ohsC,small regulatory RNA OhsC,2700520,2700598,78,+,2700519,2700599,CAAGTTGCTTGTAAAAGATAAGTACACTGATCCATAATCGCTGTTggcttgtcgacgacggcggtctccgtcgtcaggatcatAAAGAGAACGGTATTATTTTTAACTTTCAATAATTACCGTGGCAC
41,omrA,small regulatory RNA OmrA,2976102,2976189,87,+,2976101,2976190,AGATTACACGAGATAAAGAACGCGAGCGACAGTAAATTAGGTGCGggcttgtcgacgacggcggtctccgtcgtcaggatcatATCTTGATTGTGGTCTGCACGACGACTCTTCGCCAGCGAGAAAAC
42,omrB,small regulatory RNA OmrB,2976304,2976385,81,+,2976303,2976386,CGAGGTGTGTAAATTGTCGGTTACTGTTACAGATTGATGACCGGCggcttgtcgacgacggcggtctccgtcgtcaggatcatATCACCACTTTAGCAACCTGAAGCCAAACGCCACCAGCGGTCAAT
43,orzP,small RNA OrzP,2204402,2204484,82,+,2204401,2204485,ATTATCTTAATTGCAACGGGGTCCAGCCGTGGTTATAATTCGTTCggcttgtcgacgacggcggtctccgtcgtcaggatcatATTTACTGTGATCTGCTTTCCAGATATTTTTCGCTCAAACAACTA
44,oxyS,small regulatory RNA OxyS,4158278,4158394,116,+,4158277,4158395,TGAACGATTATCCCTATCAAGCATTCTGACTGATAATTGCTCACAggcttgtcgacgacggcggtctccgtcgtcaggatcatGCCATAAAAAAGCCCGGCGATAAGCCAGGCTCAAATTTATACATA
45,pspH,small regulatory RNA PspH,4263139,4263249,110,+,4263138,4263250,TTCTGGAAAGCCGGGCGACGCAAGGTTCCAGCCTGCTGATTCCATggcttgtcgacgacggcggtctccgtcgtcaggatcatAATTCCTATTTTGTTCTAAGGATAAAACCTTAGGTTGTGATCATC
46,raiZ,small RNA RaiZ,2737381,2737542,161,+,2737380,2737543,GGTTGCCAGTGGTAAACATGAAGATATGTACACCGCAATTAACGAggcttgtcgacgacggcggtctccgtcgtcaggatcatGTTGACAGCGTGAAAACAGTACGGGTACTGTACTAAAGTCACTTA
47,ralA,Rac prophage; small regulatory RNA antitoxin RalA,1413556,1413734,178,+,1413555,1413735,GGAATAAACGAACCACTGGAAATAATAATGGAGGTGTTCATGTATggcttgtcgacgacggcggtctccgtcgtcaggatcatGAGAATTGCATTGTATTCAAATTAAAACTTCATAGCTGATTATTA
48,rbsZ,small regulatory RNA RbsZ,3937045,3937278,233,+,3937044,3937279,AAGAACAACGAGGCTGCCTGCGTTTTGCATATTCGGGATGTCCATggcttgtcgacgacggcggtctccgtcgtcaggatcatGCTGCTAGTTTGCCATCATTCACCGCTTTTTCGCCATCCGGTGTA
49,rdlA,putative antisense regulatory RNA RdlA,1269323,1269389,66,+,1269322,1269390,CAATGTTGCGGGGGCTTTATCCCTGGTGGCATTGGTTGCTGGAAAggcttgtcgacgacggcggtctccgtcgtcaggatcatAATTCAAGAATAGCCGCAAAATGTTGTCATTACAACAAGGCGGCT
50,rdlB,putative antisense regulatory RNA RdlB,1269858,1269923,65,+,1269857,1269924,AATGTTGCGGGGGCTTTATCCCTGGTGGCATTGGTTGCTGGAAAGggcttgtcgacgacggcggtctccgtcgtcaggatcatACTTCAAGAATAGCCGCAAAATGTTGTCATTACAACAAGGCGGCT
51,rdlC,putative antisense regulatory RNA RdlC,1270393,1270460,67,+,1270392,1270461,CGCAATGTTGCGGGGCTTTATCCCTGGTGGCATTGGTTGCTGGAAggcttgtcgacgacggcggtctccgtcgtcaggatcatACTTCAAGAATAGCCGCAAAATGTTGTCATTACAACAAGGCGGCT
52,rdlD,antisense regulatory RNA RdlD,3700136,3700199,63,+,3700135,3700200,GCCGCCTGTGTTGTAATGACAACGTTTCGCGGCTATTCTTGAGTGggcttgtcgacgacggcggtctccgtcgtcaggatcatCTCTCTCCAGCAACCAATGCCACCAGGGATAAAGCCCCCGCAACA
53,rirA,small regulatory RNA RirA,3808166,3808238,72,+,3808165,3808239,AATGGCTTTTCCACTAGCGACTCTTTTGTGTGATTGTCTGGTTAAggcttgtcgacgacggcggtctccgtcgtcaggatcatCGTGCTAGTGTATCATTTCTTTCGCAGCAATCCGACCCGAATGAT
54,rprA,small regulatory RNA RprA,1770372,1770477,105,+,1770371,1770478,ACGAATCTGATCGACGCAAAAAGTCCGTATGCCTACTATTAGCTCggcttgtcgacgacggcggtctccgtcgtcaggatcatAACATTTTTCCGCTTCGCTACCTCGCCCCTCACTCTTTCCAATAA
55,rseX,small regulatory RNA RseX,2033649,2033739,90,+,2033648,2033740,ATTAATTCATTTAATCAATATATTAGCACTGATTACAATTATACCggcttgtcgacgacggcggtctccgtcgtcaggatcatATGCCTTCATTAATGTGCGCCTGATCACACCAGCCGTTTGGCGCA
56,rttR,small RNA RttR,1287066,1287236,170,+,1287065,1287237,CATCGACTTCGAAGGTTCGAATCCTTCCCCCACCACCATCACTTTggcttgtcgacgacggcggtctccgtcgtcaggatcatTCACTTTCAAAAGTCCCTGAACTCTCAAGCGAATCCGCAATCAAA
57,rybA,small RNA RybA,852725,853064,339,+,852724,853065,GGTACAAAAAATTAACGTTTTAGCAATAGCTATATAATATAGCCTggcttgtcgacgacggcggtctccgtcgtcaggatcatATCTTCTTGCAGCCCTGCGTATATTGCGGCTCGCGGATGCGGACC
58,rybB,small regulatory RNA RybB,887979,888057,78,+,887978,888058,TGCACAACCGCAGAACTTTTCCGCAGGGCATCAGTCTTAATTAGTggcttgtcgacgacggcggtctccgtcgtcaggatcatGTTATCTAAAACTTATCTACTACCCTGCAACCCTCTCAACCATCC
59,rydB,small regulatory RNA RydB,1764713,1764780,67,+,1764712,1764781,AAATAAGAAAACCCTTAAGTCTGTGCGACACAGGCTTAAGGGTTTggcttgtcgacgacggcggtctccgtcgtcaggatcatCTCATAAAGCTAACCCGCCGTTTTAACACAAACTGCGATTAGTAT
60,rydC,small regulatory RNA RydC,1491442,1491506,64,+,1491441,1491507,CAAGGATTATGGTTTTATTTATCATACAAATAAATATAATAGGCGggcttgtcgacgacggcggtctccgtcgtcaggatcatAAATATCCTTCAGGAACGTTTACGCGGCATCATGCGTAGAAGTGT
61,ryeA,small antisense RNA RyeA,1923066,1923337,271,+,1923065,1923338,AAAACGCTGGACTCAGACAGTAGAGTGTGTGTTATGGTTGACTATggcttgtcgacgacggcggtctccgtcgtcaggatcatTGGAAATCAAAAGGCTATTTTAGGTAATTAACAGAGTTTTTCAGC
62,ryeG,small RNA RyeG,2470472,2470665,193,+,2470471,2470666,CAAAGAAATCAAGACAATAGCGATGTAAAGCACTAAGTTTAAATTggcttgtcgacgacggcggtctccgtcgtcaggatcatGTGCTGATATTATCATCAACAGTGATAGATACATATACTAACTGA
63,ryfA,small regulatory RNA RyfA,2653855,2654158,303,+,2653854,2654159,CAAGCAAAAGAGAGTTATTATTGTTCTGTTAGTGTATTATCCACTggcttgtcgacgacggcggtctccgtcgtcaggatcatAGATTATCCGATTCTGTTTAAAGTCACGCAAAAAACCACCCCAGC
64,ryfD,small regulatory RNA RyfD,2734153,2734295,142,+,2734152,2734296,GAGTGCAAGTGATTGGGCATCGGCAAGAGCAAGCTGGAATTTATTggcttgtcgacgacggcggtctccgtcgtcaggatcatCTTTAGGTTATATCAGCCAAATGAAACTTGCCATACGACCGGTGG
65,ryhB,small regulatory RNA RyhB,3580922,3581016,94,+,3580921,3581017,TAACGAACACAAGCACTCCCGTGGATAAATTGAGAACGAAAGATCggcttgtcgacgacggcggtctccgtcgtcaggatcatGAGACAATAATAATCATTCTCATTCGCACTTGTCCAACACTTTTT
66,ryjA,small RNA RyjA,4277926,4278066,140,+,4277925,4278067,TACTTTTACACTGGCGAAGAAACGTCGGTGACATACAATTAAAGCggcttgtcgacgacggcggtctccgtcgtcaggatcatGTTCATCTTCCAGCAAGCGTGCGCCGGTACCTTCTTCTCCTAAGC
67,ryjB,small RNA RyjB,4527977,4528066,89,+,4527976,4528067,AGATGGGGATAAGCAGAGCGCTTATCCCCGGCAAAGAGCAATAACggcttgtcgacgacggcggtctccgtcgtcaggatcatTTAACGATATTAAATGGGTACAGGCACAACGTAAAGCCACCGACT
68,sdhX,small regulatory RNA SdhX,765050,765150,100,+,765049,765151,CTATAAATTTACCCTGATAGCGCAGCGAAAATCATCGCGATAAGCggcttgtcgacgacggcggtctccgtcgtcaggatcatTTATTTCAGAACAGTTTTCAGTGCTTCACCGATATCCGCCAGGCT
69,sdsN,small regulatory RNA SdsN,1996921,1997057,136,+,1996920,1997058,TAATTCAAACTATCACATAAATAAGATTTATATATAATTTATATTggcttgtcgacgacggcggtctccgtcgtcaggatcatCTTATTATTGCAGCAGAAACTTCTCGAGGAACTGGCGGGTGCGAG
70,sdsR,small regulatory RNA SdsR,1923104,1923207,103,+,1923103,1923208,TGACTATAAAGTCAGCGAAGGAAATGCTTCTGGCTTTTAACAGATggcttgtcgacgacggcggtctccgtcgtcaggatcatCTTTAAGAATAGATGACGACGCCAGGTTTTCCAGTTTGCGTGCAA
71,sgrS,small regulatory RNA SgrS,77367,77593,226,+,77366,77594,CGTCATTATCCAGATCATACGTTCCCTTTTTAGCGCGGCGAGAATggcttgtcgacgacggcggtctccgtcgtcaggatcatGTTAGGAATTATTGACTTAATATAGGGAAAATAAAATTGCTGTCT
72,sibA,small RNA SibA,2153311,2153454,143,+,2153310,2153455,AGCCGTCGATTGACACTAAGGGCGGAGTGACATAATTTCAGGAGTggcttgtcgacgacggcggtctccgtcgtcaggatcatGTTTCAGCGTCCCGCTGAAATCATCGGCTTACCTCCTTTCGCCCT
73,sibB,small RNA SibB,2153646,2153781,135,+,2153645,2153782,GCCTGCGGATTGACAATCTTATCGTGAAGGCATACTTTCAGGAGTggcttgtcgacgacggcggtctccgtcgtcaggatcatCGTTTCAGCGTCCCGCTGAAATCGTCGGCTTACCTCCTTTCGCCA
74,sibC,small regulatory RNA antitoxin SibC,3056851,3056991,140,+,3056850,3056992,TCGCCCTGATTGACATCGTTGATTCTTTGACCTAATTTAGTGAGTggcttgtcgacgacggcggtctccgtcgtcaggatcatGTTACAGCCCCATGCTGCCCTGCCATCGTAAATCCCCATTAAATA
75,sibD,small RNA SibD,3194721,3194865,144,+,3194720,3194866,TCTGGCGCTCATCAACAATCGGGGAGTCAGCAGGGGGCTGAAACGggcttgtcgacgacggcggtctccgtcgtcaggatcatTCCTTTACTTTAGGTTGAAAAAAAATCAGCGTCAAGAAGGTTTCA
76,sibE,small RNA SibE,3195097,3195240,143,+,3195096,3195241,GTCCGGCGCTCATCAACAATCGGGGGGCAGCAAGGGGCTGAAACGggcttgtcgacgacggcggtctccgtcgtcaggatcatTCCTTTACTCTAGGTTGAAAAAACAACAGCGTCAATAGGCCTGCC
77,sokB,putative small regulatory RNA antitoxin SokB,1492119,1492174,55,+,1492118,1492175,GCGGGTGCCTGAGACTTTCTGTTTTCAGGCTAACCGGGAATCAGAggcttgtcgacgacggcggtctccgtcgtcaggatcatAATTCAGATCTTAGCCTCTTACCCGCCATCCGGCAAGGAGAAAGG
78,sokC,small regulatory RNA antitoxin SokC,16952,17006,54,+,16951,17007,GTGCTTGAGGCTGTCTGTCTCAGGCATTAGCTGAACGGCAGATAGggcttgtcgacgacggcggtctccgtcgtcaggatcatACATGTAGAGTGCCTCTTACTGACCGTAAGGTCAAGGAGAAGAGA
79,sokE,small RNA SokE,607734,607792,58,+,607733,607793,ATGTTTATATTGCCTCCATGCGAAGAAGGGACTACCATCCAAATTggcttgtcgacgacggcggtctccgtcgtcaggatcatTCCAGACCTCAGAGTAAACCTGAAACCGGAAAGCTTCAGGCACCC
80,sokX,small RNA SokX,2887353,2887408,55,+,2887352,2887409,ACACATGTCTTGCCTCCCTGCAAAGAAGAGACTAACATTCGAATTggcttgtcgacgacggcggtctccgtcgtcaggatcatCATCTGGAACCTCGCGAATGCTTAACGCCAGACAGCCTCAAGCAC
81,spf,small regulatory RNA Spot 42,4049899,4050009,110,+,4049898,4050010,TGATAAACATAGCGCATCAGGCATTACGGATCTTTTCTTTCGCCCggcttgtcgacgacggcggtctccgtcgtcaggatcatGCGACTAACTTTACTCTTTTTTGTTCAGTTCAGAAAGCACTTTTT
82,sraA,small RNA SraA,458728,458784,56,+,458727,458785,GCCATCTATTAACATGTACGTCAGTATATGGGGATGTTTCCCCCAggcttgtcgacgacggcggtctccgtcgtcaggatcatGTTAACTAATTGTATGGGAATGGTTAATTATTCACCAGATGCCTG
83,sraB,small RNA SraB,1146589,1146757,168,+,1146588,1146758,CTTTTGCATAGGGCGCGCATATTAACTTTGTAACGTCATAGAGTCggcttgtcgacgacggcggtctccgtcgtcaggatcatAACTTATTTTAGCCTCCACCTCGCCATGGCGTCGCGCTCTTCTGG
84,sraG,small regulatory RNA SraG,3311183,3311398,215,+,3311182,3311399,ACTGGAATTTACGAACGATCGGATTAAGCAATGTAATATCCTTTCggcttgtcgacgacggcggtctccgtcgtcaggatcatCTGAAACTCGCAAGAATTAGCGACGCAGACCCAGGCGCTCGATGA
85,sroA,small RNA SroA,75516,75608,92,+,75515,75609,GGATCCATGATTGCTGGTTGATAACAAAATCACTACACTAACGCCggcttgtcgacgacggcggtctccgtcgtcaggatcatCTCAAGTCCTTTGCCACTCTTTTTTGAGGTGCAAAGTGTTAAAAA
86,sroC,small regulatory RNA SroC,686681,686843,162,+,686680,686844,ACGAAATGAAAGCACTGTTCAAAGAACCGAATGACAAGGCACTGAggcttgtcgacgacggcggtctccgtcgtcaggatcatGGAGTAGATTTATGTCTATAGACTGGAACTGGGGTATTTTTTTAC
87,sroE,small RNA SroE,2640595,2640686,91,+,2640594,2640687,CGAATGGCTTGAATGTTTTTTGCCACGTTTATTCTCTTTCTGAATggcttgtcgacgacggcggtctccgtcgtcaggatcatTATTTTTCAACCTGCTGAACGTCAATTCGACGCGCTTCGTCCAGC
88,sroH,small RNA SroH,4190327,4190487,160,+,4190326,4190488,AGAGATCTGATTGTAAGAGAGTAAATACTCAACTATGATAGAGACggcttgtcgacgacggcggtctccgtcgtcaggatcatGTTATTTTGAGGGCTGAGGAAGCTGCTTATTTCTCAATAAGTTGT
89,ssrA,tmRNA,2755593,2755955,362,+,2755592,2755956,CTGGTCATGGCGCTCATAAATCTGGTATACTTACCTTTACACATTggcttgtcgacgacggcggtctccgtcgtcaggatcatAAATTCTCCATCGGTGATTACCAGAGTCATCCGATGAAGTCCTAA
90,ssrS,6S RNA,3055983,3056165,182,+,3055982,3056166,ATGACACTTTTCGGTTTACTGTGGTAGAGTAACCGTGAAGACAAAggcttgtcgacgacggcggtctccgtcgtcaggatcatCCTTCTTATCTGGCACCAGCCATGACGCAACTACCAGAACTCCCA
91,symR,small regulatory RNA antitoxin SymR,4579835,4579911,76,+,4579834,4579912,TAGCTGGACTTTCCCCATATTTACTGATGATATATACAGGTATTTggcttgtcgacgacggcggtctccgtcgtcaggatcatGACACGCATTCTATTGCACAACCGTTCGAAGCAGAAGTCTCCCCG
92,tff,putative small RNA T44,189712,189847,135,+,189711,189848,GCATGGAAACAGTTGCCATGATTAAAACCTCTATATAAAAGTTGGggcttgtcgacgacggcggtctccgtcgtcaggatcatGCGCGCTTTATACCACAAATACGTCGTGGACACCAATAATTGTTG
